11111111111111111111111111
10000000000000000000000001
10000010000000000010000001
10P00010000000000010000001
100000000000C0000000000001
10000000000000000000000001
10000100000001000000110001
1000000111111E111111000001
11110000000001000000000001
11111111111111111111111111