11111111111
1000PC00001
10000000E01
11111111111


