11111111111111111111111111
10000000000000000000000001
10000010000000000010000001
10P00010000000000010000001
100000000000C000000000
10000000000000000000000001
10000100000000000000110001
1000000111111E11111100000
11110000000000000000000001
1111111111111111111111111